{
  "field": [
    "##########",
    "#........#",
    "#........#",
    "#........#",
    "#....S...#",
    "#........#",
    "#........#",
    "#........#",
    "#........#",
    "##########"
  ],

  "initial_snake_length": 3,
  "max_step_limit": 1000,

  "rewards": {
    "timestep": 1,
    "ate_fruit": 1000,
    "died": -1000
  }
}
